NO ./assets/textures/LavaF2.xpm
SO ./assets/textures/Bricks.xpm
WE ./assets/textures/Sand.xpm
EA ./assets/textures/WoolSnow.xpm

C 130,130,130
F 0,255,0
B 0,0,0
W 255,255,255

11111111
10000001
10000101
10001101
10001001
10001N01
10000001
11111111
