NO ./assets/textures/LavaF2.xpm
SO ./assets/textures/Bricks.xpm
WE ./assets/textures/Sand.xpm
EA ./assets/textures/WoolSnow.xpm

C 97,200,207
F 36,85,1


		1111111111111111111111111
		1000000000110000000000001
		1011000001110000000000001
		1001000000000000000000001
111111111011000001110000000000001
100000000011000001110111111111111
11110111111111011100000010001
11110111111111011101010000001
11000000110101011100000000001
10000000000000001000010010001 
10000000000000000001110010001
11000001110101011111000000N0111
11110111 1110101 101111010001
11111111 1111111 111111111111