NO ./assets/blue.xpm
SO ./assets/green.xpm
WE ./assets/red.xpm
EA ./assets/yellow.xpm

C 97,200,207
F 125,125,125

11111
10001
1N010
11111