NO ./assets/green.xpm
SO ./assets/blue.xpm
WE ./assets/red.xpm
EA ./assets/yellow.xpm

C 97,207,231
F 36,85,1

11111111
10000001
10001001
10001001
10001001
10001S01
10001001
11111111
